R 640 800

NO textures/redbrick.xpm

SO textures/bluestone.xpm

WE textures/greystone.xpm

EA textures/colorstone.xpm

S textures/barrel.xpm

F 220,0,180

C 225,30,0

111111111111111111111111
100000000220000000000001
111111000020000000000001
100N00000000000000000001
100000100010000101010001
100200100010000000000001
100000111110000100010001
100000000000200000000001
111111000000000111110001
100000000000000000000001
100000000000000000000001
100000000020000000000001
100000000000000000200001
110100001000000000100001
110000101002000000100001
110100001000000000000001
110111111000000000200001
110000000000000000000001
111111111000000000000001
111111111111111111111111
